1111111111
1E11111111
1C11111111
1111111111
1011111111
1011111111
1011111111
1011111111
1011111111
1011111111
1011111111
1011111111
1011111111
1011111111
1011111111
1011111111
1011111111
1011111111
1011111111
1011111111
1011111111
1011111111
1011111111
1011111111
1011111111
1011111111
1011111111
1011111111
1011111111
1011111111
1011111111
1011111111
1011111111
1011111111
1011111111
1011111111
1011111111
1011111111
1011111111
1011111111
1011111111
1011111111
1011111111
1011111111
1011111111
1011111111
1011111111
1011111111
1011111111
1011111111
1011111111
1011111111
1P11111111
1111111111