11111111111111111111111111111111111111111111111111111111111
10000000000000000000000000000000000000011000000000000000001
10000000000000000000000000000000000000011000000000000000001
10000000000000000000000000000000000000011000000000000000001
1000000000000000000000000000000000000001100CCCCCCCCC0000001
10000000000000000000000000000000000000011000000000000000001
1000000000CC00000000000000000000000000011000000000000000001
10000000000000000000000000000000000000011001111111111111111
1000000000000000000000000000000000000001100000C000000000001
10000000C00000000000000000000000000000011000000000000000001
10001111111111111111000000000000000000011111111111111111001
10001CCCCCCCCCCCCCC1000000000000000000011111111111111111001
10001C11111111111111000000000000C00000000000000000000000001
10000000000000000000000000000000000000000000000000000000001
10000000000000000000000000000000000000000000000000000000001
10000000000000000000000000000000000000000000000000000000001
10000000000000000000000000000000000000000000000000000000001
100000000000000000001111111111111000C0000000000000000000001
1000000000000000000P100000000000100000000000000000000000001
10000000000000000000110111111110100000000000000000000000001
10000000000000000000100100000010100000000000000000000000001
10000000000000000000101101111010100000000000000000000000001
10000000000000000000100101C01010100000000000000000000000001
10000000000000000000110101101010100000000000000000000000001
100000000000000000001001000010101000000000000000000000000C1
10000000C00000000000101111111010100000000000000000000111111
1000000000000000000010000000001010000000000000000000C1C0001
10000000000000000000111111111110100000001111111111111110101
100000000000000000000C00000000001000000000000000000000001E1
11111111111111111111111111111111111111111111111111111111111