1111111111111111111111111111111111111111111111111
100001111100000000000C00000000C000000000000100C01
100001111100000000000C00000000C000000000000100C01
100001111100000000000C00000000C000000000000100C01
100001111100000000000C00000000C000000000000100C01
100001111100000000000C00000000C000000000000100C01
100001111100000000000C00000000C000000000000100C01
100001111100000000000C00000000C000000000000100C01
100001111100000000000C00000000C000000000000100C01
100001111100000000000C00000000C000000000000100C01
100001111100000000000C00000000C000000000000100C01
100001111100000000000C00000000C000000000000100C01
100001111100000000000C00000000C000000000000100C01
100001111100000000000C00000000C000000000000100C01
100001111100000000000C00000000C000000000000100C01
100001111100000000000C00000000C000000000000100C01
100001111100000000000C00000000C000000000000100C01
100001111100000000000C00000000C000000000000100C01
100001111100000000000C00000000C000000000000100C01
100001111100000000000C00000000C000000000000100C01
100001111100000000000C00000000C000000000000100C01
100001111100000000000C00000000C000000000000100C01
100001111100000000000C00000000C000000000000100C01
100001111100000000000C00000000C000000000000100C01
100001111100000000000C00000000C000000000000100C01
100001111100000000000C00000000C000000000000100C01
100001111100000000000C00000000C000000000000100C01
100001111100000000000C00000000C000000000000100C01
100001111100000000000C00000000C000000000000100C01
100001111100000000000C00000000C000000000000100C01
100001111100000000000C00000000C000000000000100C01
100000000000000000000C00000000C000000000000100C01
100001111100000000000C00000000C000000000000100C01
100001111100000000000C00000000C000000000000100C01
100001111100000000000C00000000C000000000000100C01
100001111100000000000C00000000C000000000000100C01
100001111100000000000C00000000C000000000000100C01
100001111100000000000C00000000C000000000000100C01
100001111100000000000C00000000C000000000000100C01
100001111100000000000C00000000C000000000000100C01
100001111100000000000C00000000C000000000000100C01
100001111100000000000C00000000C000000000000100C01
100001111100000000000C00000000C000000000000100C01
100001111100000000000C00000000C000000000000100C01
100001111100000000000C00000000C000000000000100C01
100001111100000000000C00000000C000000000000100C01
100001111100000000000C00000000C000000000000100C01
100001111100000000000C00000000C000000000000100C01
1P0011E00000000C00000000000CCCC000000000000000001
1111111111111111111111111111111111111111111111111