11111
1E111
1C111
11111
10111
10111
10111
10111
10111
10111
10111
10111
10111
10111
10111
10111
10111
10111
10111
10111
10111
10111
10111
10111
10111
10111
10111
10111
10111
10111
10111
10111
10111
10111
10111
10111
10111
10111
10111
10111
10111
10111
10111
10111
10111
10111
10111
10111
10111
10111
10111
10111
1P111
11111