11111111111111111111
1000000000C000100E01
1001100000C000101111
1001100000C000100C11
1001100000C000100C01
1001100000C000100C01
1001100000C000100C01
1001100000C000100C01
1001100000C000100C01
1001100000C000100C01
1001100000C000100C01
1001100000C000100C01
1001100000C000100C01
1001100000C000100C01
1001100000C000100C01
1001100000C000100C01
1001100000C000100C01
1001100000C000100C01
1001100000C000100C01
1001100000C000100C01
1001100000C000100C01
1001100000C000100C01
1001100000C000100C01
1001100000C000100C01
1001100000C000100C01
1001100000C000100C01
1001100000C000100C01
1001100000C000100C01
1001100000C000100C01
1001100000C000100C01
1001100000C000100C01
1001100000C000100C01
1001100000C000100C01
1001100000C000100C01
1001100000C000100C01
1001100000C000100C01
1001100000C000100C01
1001100000C000100C01
1001100000C000100C01
1001100000C000100C01
1001100000C000100C01
1001100000C000100C01
1001100000C000100C01
1001100000C000100C01
1001100000C000100C01
1001100000C000100C01
1001100000C000100C01
1001100000C000100C01
1001100000C000100C01
1001100000C000100C01
1001100000C000100C01
1001100000C000100C01
1001100000C000100C01
1001100000C000100C01
1001100000C000100C01
1001100000C000100C01
1001100000C000100C01
1001100000C000100C01
1001100000C000100C01
1001100000C000100C01
1001100000C000100C01
1001100000C000100C01
1001100000C000100C01
1001100000C000100C01
1001100000C000100C01
1001100000C000100C01
1001100000C000100C01
1001100000C000100C01
1001100000C000100C01
1001100000C000100C01
1001100000C000100C01
1001100000C000100C01
1001100000C000100C01
1001100000C000100C01
1001100000C000100C01
1001100000C000100C01
1001100000C000100C01
1001100000C000100C01
1001100000C000100C01
1001100000C000100C01
1001100000C000100C01
1001100110C000100C01
1001100000C000100C01
1001100000C000100C01
1001100000C000100C01
1001100000C000100C01
1001100000C000100C01
1001100000C000100C01
1001100000C000100C01
1001100000C000000C01
1001100000C000000C01
1001100000C000100C01
1001100000C000100C01
1001100000C000100C01
1001100000C000100C01
1001100000C000100C01
1001100000C000100C01
1001100000C000100C01
10P1100000C000100C01
11111111111111111111