11111111111111111111111111111
10000F11100000000000000F00001
1000011C111000000000000000001
10110000000000010000000000001
10011011111111010000000000001
10010010000F01010000000000001
10010110111101010000000000001
100100101C0101010000000000001
10011010110101010000000000001
100100100001010100000000000C1
1001011111110101000000F111111
1001000000000101000000C1C0001
10010111111111010011111110101
1CP10000000000C100000000001E1
11111111111111111111111111111