1111111111111111111111111111111111
1E0000000F00000C00000C01F100000001
10100101001000001010010111000101F1
10100100101F1010001001000001010101
1P0000000C00C0000000000000000000C1
1111111111111111111111111111111111