111111111
1E1111111
1C1111111
111111111
101111111
101111111
101111111
101111111
101111111
101111111
101111111
101111111
101111111
101111111
101111111
101111111
101111111
101111111
101111111
101111111
101111111
101111111
101111111
101111111
101111111
101111111
101111111
101111111
101111111
101111111
101111111
101111111
101111111
101111111
101111111
101111111
101111111
101111111
101111111
101111111
101111111
101111111
101111111
101111111
101111111
101111111
101111111
101111111
101111111
101111111
101111111
101111111
1P1111111
111111111