1111111
1E11111
1C11111
1111111
1011111
1011111
1011111
1011111
1011111
1011111
1011111
1011111
1011111
1011111
1011111
1011111
1011111
1011111
1011111
1011111
1011111
1011111
1011111
1011111
1011111
1011111
1011111
1011111
1011111
1011111
1011111
1011111
1011111
1011111
1011111
1011111
1011111
1011111
1011111
1011111
1011111
1011111
1011111
1011111
1011111
1011111
1011111
1011111
1011111
1011111
1011111
1011111
1P11111
1111111