111111
1E1111
1C1111
111111
101111
101111
101111
101111
101111
101111
101111
101111
101111
101111
101111
101111
101111
101111
101111
101111
101111
101111
101111
101111
101111
101111
101111
101111
101111
101111
101111
101111
101111
101111
101111
101111
101111
101111
101111
101111
101111
101111
101111
101111
101111
101111
101111
101111
101111
101111
101111
101111
1P1111
111111