111111111111111111111111111111111111111111111111111111111
1P0010F10F10F10F10F10F10F10F10F10F10F10F10F10F10F100000E1
10001C11C11C11C11C11C11C11C11C11C11C11C11C11C11C110000001
100000000000000000000000000000000000000000000000000000001
10001C11C11C11C11C11C11C11C11C11C11C11C11C11C11C110000001
100010F10F10F10F10F10F10F10F10F10F10F10F10F10F10F10000001
100011111111111111111111111111111111111111111111110000001
100000000000000000000000000000000000000000000000000000001
100CCCCCCCCCCCCCCCCCCCCCCCCCCCCCCCCCCCC000000000000000001
100000000000000000000000000000000000000000000000000000001
111111111111111111111111111111111111111111111111111111111